######################################################################
##................################.....##..................##..#.....#
####..............#...#############.....#......................#.....#
################......######..######....#..#########..###......#.....#
#..............#...........#..######....#..##..........##..##..#..#..#
#..............#...........#.....###.......##..........##..##.....#..#
##....................##..........##.......###..#########..##.....#..#
##....#....#......######......#...##.......................##.....####
##....#....#.....#######...#####...#...##..................##.......##
####..######......#####.....####......######..######..#########.....##
##.....#####..############..####.....#####.....#####..############..##
##......####..###.....####..###...#..#####...#######..############..##
##......####..##........##........#....####..#...#......#....#.......#
##......####..##........##.......##.......#..#...#......#....#.......#
##..########..###.......##..###############..#...#......#....#..######
#...##..##########.....###..#####....≈....########......#....#.......#
#...##..........##..############.....≈...........#......#....#.......#
#...##........@......................≈.......>...#......#.......#....#
############.........................≈.##........#####..#.......#....#
######...###.....#####################################..######..#....#
##...#...###.....######..########.....##############.....#####......##
##...#...###.....####....#.............##.......###........##........#
#....#...###.....####....#......................###........##........#
#....#....###...#####..#############.......##...#....##....##......###
##...#....###########..#...............#...##.........#....##..#######
##..##..........#####..#...............#...##.........#..####.....#..#
##..............#.........##########...#...##.........#...........#..#
##........#..####.........#............######..##.....#..............#
##......###........##..#..#............####.....#######..####........#
###.....###........#####..######......#####.....#######....#####..####
######..################..######......########..###...#....#####..####
###......############........###............##..###...#....#####..####
##.............######........######.........##........#....#####...###
#...............#...#..#.....######.........##........######..##....##
#...##....##........#..#.....##.......########....#...######...##....#
#...#.....####.........########...................#.............##...#
#.........#####...................................#..................#
#....#...######.....#..............#######......###.......##.........#
##.......#######...##..#########.....#####......###.......####.....###
######################################################################
