│┌──────┬─────────┐│┌──┬─────┐│#│┌──┐└─┘┌───┐│┌────────────┐┌───┐│####
││......│.........└─┘..│.....│└─┘│..├───┤...└┐│............└┘...││####
││......│..............├──┐..├───┤..│...│....└┤.................││####
││......│..┌──┐........│┌─┘..│...│..│.........│..┌─────.........│└────
┘└┐....┌┤..│──│.....┌──┘│....│...│..│.........│..│..........│...└────┐
┌─┴─..─┴┘..├──┘.....│┌─┐│........│..│.........│..│..........│........│
│..........│........││#││.....┌┬─┴──┴──┬─.....│..└────┐...│.│........│
│..........│.......┌┘│#││....┌┘│.......│......│.......│...├─┤.......┌┘
└──┐..┌────┤..┌────┘┌┘#││....│││.┌─.─┐.│......│.......│...│││.......│┌
───│..│───┐│..└───┐─┴──┘└┐..┌┘││.│...│.│......└┬───┐..└───┤│└─┬───..││
┌──┘..└──┐││......└─────┐│..│─┘│.......│.......│┌┐┌┘......├──┐│.....│└
│........└┐│............│├──┴──┤.│...│.│.......││││.......│..├┘.....└┐
│.........│└──┐.........││..~..│.└─.─┘.│.......││││...┌───┘..│.......│
│.........├───┘.........││..~..│.......│......┌┘│││...│......│.......│
│..┌───┐..│.......┌─────┴┘..~..└───.───┴──────┤─┴┘│..........│..┌─...│
│..│┌─┐│..│.......│.........~.................├───┘..........│..│...┌┘
│..│└─┤│..........│.........~..............>..│.......│......│.....┌┘┌
├──┴─┐││.......──┬┤.........~.................│.......└──┐...│....┌┘┌┘
│....└─┴─┬─┐.....│└──┬──────┬───┬─────┬─┬─────┘..┌─┐.....│...│...┌┘─┴┐
│........│││.....│┌─┐│......│───│.....│││........│││.....├───┤..─┴──┐│
│........││└─┐..┌┘└─┘│......└───┴─┬┐..│││........│││.....└┐┌┐│......││
│..┌─┐...││┌─┘..└───┐│............││..└─┴───────┬┘││......││││......││
│..└┐└┐..└┐│........│└──┐.........││............│┌─┤......││││..────┤│
│...│││...││........├───┘.........││............││.│......││││......││
│...│││...└┘..┌┐....│.......──────┴┘....┌────┐..└┘.│..┌┐..│└┘│......││
│...│┌┘.......││....│...................│....│........││..└──┘..────┤│
│..┌┘│........││........................│....│........││............││
└──┘││....┌┐..││.........──┬───┐......┌─┤.......┌┐....││............││
────┤│...┌┘│..│├───┬─┐.....│┌─┐│......│││.......│└────┘├───┬─┬───..┌┘│
####││..┌┘││..││...│││.....││┌┘│......││└─┬───..│┌┐┌───┤...│┌┘.....│┌┘
┌───┘│..│─┘│..││...│││.....│││┌┘..────┴───┤.....│└┘│...│...││......││#
│┌───┘..└──┤..││...│││.....││││...........│.....└──┘...│...│└┐.....│└─
││.........│..││..─┴┐│..┌──┘└┘│...........│............│...└─┼┐..┌─┴─┐
││.........│..││....││..└────┐├──..─┬─────┘..│.........│.....└┘..│...│
││..│......│..└┘....└┘.......││.....│........│....┌┐...│.........│...│
││..│........................└┘.....│........│....││..─┘.........│...│
││..│............................│..│....│........││.................│
││..└───┬──────┐....┌┐...─.......│..│....│......┌─┘│..........│......│
││......│┌────┐│..┌─┘│.......┌───┤..│....│......│┌┐│......┌───┤..┌───┘
│└──────┘│####│└──┘┌┐└───────┘┌─┐└──┴────┴──────┘││└──────┘┌─┐└──┘┌───