#┌──────┬─────────┐#┌──┬─────┐###┌──┐###┌───┐#┌────────────┐┌───┐#####
#│......│.........└─┘..│.....│###│..├───┤...└┐│............└┘...│#####
#│......│..............├──┐..├───┤..│...│....└┤.................│#####
#│......│..┌──┐........│┌─┘..│...│..│.........│..┌─────.........│#####
#└┐....┌┤..│##│.....┌──┘│....│...│..│.........│..│..........│...└────┐
┌─┴─..─┴┘..├──┘.....│###│........│..│.........│..│..........│........│
│..........│........│###│.....┌┬─┴──┴──┬─.....│..└────┐...│.│........│
│..........│.......┌┘###│....┌┘│.......│......│.......│...├─┤.......┌┘
└──┐..┌────┤..┌────┘####│....│#│.┌─.─┐.│......│.......│...│#│.......│#
###│..│####│..└───┐#####└┐..┌┘#│.│...│.│......└┬───┐..└───┤#└─┬───..│#
┌──┘..└──┐#│......└─────┐│..│##│.......│.......│##┌┘......├──┐│.....│#
│........└┐│............│├──┴──┤.│...│.│.......│##│.......│..├┘.....└┐
│.........│└──┐.........││..~..│.└─.─┘.│.......│##│...┌───┘..│.......│
│.........├───┘.........││..~..│.......│......┌┘##│...│......│.......│
│..┌───┐..│.......┌─────┴┘..~..└───.───┴──────┤###│..........│..┌─...│
│..│###│..│.......│.........~.................├───┘..........│..│...┌┘
│..│###│..........│..☺......~..............>..│.......│......│.....┌┘#
├──┴─┐#│.......──┬┤.........~.................│.......└──┐...│....┌┘##
│....└─┴─┬─┐.....│└──┬──────┬───┬─────┬─┬─────┘..┌─┐.....│...│...┌┘###
│........│#│.....│###│......│###│.....│#│........│#│.....├───┤..─┴──┐#
│........│#└─┐..┌┘###│......└───┴─┬┐..│#│........│#│.....└┐##│......│#
│..┌─┐...│#┌─┘..└───┐│............││..└─┴───────┬┘#│......│##│......│#
│..└┐└┐..└┐│........│└──┐.........││............│┌─┤......│##│..────┤#
│...│#│...││........├───┘.........││............││.│......│##│......│#
│...│#│...└┘..┌┐....│.......──────┴┘....┌────┐..└┘.│..┌┐..│##│......│#
│...│┌┘.......││....│...................│....│........││..└──┘..────┤#
│..┌┘│........││........................│....│........││............│#
└──┘#│....┌┐..││.........──┬───┐......┌─┤.......┌┐....││............│#
#####│...┌┘│..│├───┬─┐.....│###│......│#│.......│└────┘├───┬─┬───..┌┘#
#####│..┌┘#│..││...│#│.....│###│......│#└─┬───..│##┌───┤...│┌┘.....│##
#####│..│##│..││...│#│.....│##┌┘..────┴───┤.....│##│...│...││......│##
#┌───┘..└──┤..││...│#│.....│##│...........│.....└──┘...│...│└┐.....│##
#│.........│..││..─┴┐│..┌──┘##│...........│............│...└─┼┐..┌─┴─┐
#│.........│..││....││..└────┐├──..─┬─────┘..│.........│.....└┘..│...│
#│..│......│..└┘....└┘.......││.....│........│....┌┐...│.........│...│
#│..│........................└┘.....│........│....││..─┘.........│...│
#│..│............................│..│....│........││.................│
#│..└───┬──────┐....┌┐...─.......│..│....│......┌─┘│..........│......│
#│......│######│..┌─┘│.......┌───┤..│....│......│##│......┌───┤..┌───┘
#└──────┘######└──┘##└───────┘###└──┴────┴──────┘##└──────┘###└──┘####