################################################################################
################################################################################
################################################################################
################################################################################
################################################################################
################################################################################
###############################...................##############################
###############################.########.########.##############################
#######################.#######.########.########.##############################
#######################.#######.########.########.##############################
#######################.#######.#####.......#####.##############################
#######################.................@.........##############################
#######################.#######.####........#####.##############################
#######################.#######.####........#####.##############################
#######################.#######.########.########.##############################
#######################.#######.########.########.##############################
#######################.######....................##############################
#######################.######...........#######################################
################################################################################
################################################################################
################################################################################
################################################################################
################################################################################
################################################################################
